@@@@@@@@@@
@F*   *  @
@   *   *@
@******  @
@    * * @
@ ** * * @
@  *   * @
@* * *** @
@I *     @
@@@@@@@@@@
