@@@@@@@@@@
@I       @
@***** * @
@      * @
@ *** ** @
@  *   * @
@*** * * @
@    * * @
@F****   @
@@@@@@@@@@