@@@@@@@@@@@@@@@@@@@@@@@@@@@@@@@@@@@@@@@@
@I *   *   *      *   *   *            @
@* * *   *   **** * * * * * * *********@
@  * *********    * * * * * *          @
@*           * **** * * * * ***********@
@*** *** *** *      *   *              @
@  *   *   * ************************* @
@* *** ***                             @
@        ****** ***************** *****@
@* ***** *   **   *        *           @
@  *   * * *  *** * ****** * **********@
@ ** * *   **   * *      * * *         @
@    * *****  * ********** * * ******* @
@*****        *            * * *     * @
@    **** ******** ********* * ***** * @
@ **      *                * *       * @
@  ******** ************** * ********* @
@*    *   *       *        *           @
@  ** * * ******* * *******************@
@***    * * * **  *  ***   ***   ***   @
@  ****** *   *  ***  ** *  ** *  *  * @
@*  *   * ** *  *   *  *  *  * **   *  @
@     *   *    *     *  *  *   *****  *@
@ *************       *  *  ***   *  * @
@                      *  * **  *   *  @
@                       *   *  * ***   @
@                        ***  *        @
@                                      @
@                                      @
@                                      @
@                                      @
@                                      @
@                                      @
@                                      @
@                                      @
@                                      @
@                                      @
@                                      @
@                                      @
@                                      @
@                                      @
@                                      @
@                                      @
@                                      @
@                                      @
@                                      @
@                                      @
@                                      @
@                                      @
@                                      @
@                                      @
@                                      @
@                                      @
@                                      @
@                                      @
@                                      @
@                                      @
@                                      @
@                                      @
@@@@@@@@@@@@@@@@@@@@@@@@@@@@@@@@@@@@@@@@